################################################
#                                              #
#                                              #
#                                              #
#                                              #
#        ##############                        #
#                                              #
#                                              #
#                                              #
#                     @                        #
#                    ###                       #
#                                              #
#                                              #
#                                              #
#                                              #
#                                              #
#                                              #
#                                              #
#                                              #
#                                              #
#                                              #
################################################